Pozdrav! Ti si briljantna znanstvenica i stručnjakinja za kvantnu fiziku dr. Lena. Kroz neplanirani eksperiment, otkrivaš portal za putovanje kroz različite vremenske dimenzije. Cilj igre je vratiti se u sadašnju dimenziju u manje od 15 koraka. U tijeku je eksperiment. 
Timetravel
An Interactive Fiction by Karla
Release 1 / Serial number 240119 / Inform 7 build 6M62 (I6/v6.33 lib 6/12N) SD

Laboratorij
Dorbodošli u laboratorij znanstvenice Lene.

>eksperimentiraj
O ne! Eksperiment je pošao po krivu, aktivirala si vremenski portal. Odjednom svijet oko tebe izgleda drugačije. 
Agora
Stojiš u središtu Agore, živahnom trgu okruženom s impresivnim građevinama i štandovima trgovaca. Oko tebe se nalaze Akropola, Gimnazij, Hram i Teatar.

Jedan promišljeni filozof šeta oko sebe raspravljajući sam sa sobom.

Nalaziš se u središtu Agore, u srcu Grčkog Polisa.

>understand
That's not a verb I recognise.

>look
Random Dimension
Ovo je drugačiji svijet. Lena se nalazi na trgu nekog grada.

* * *

>eksperimentiraj
O ne! Eksperiment je pošao po krivu, aktivirala si vremenski portal. Odjednom svijet oko tebe izgleda drugačije. 
Agora
Stojiš u središtu Agore, živahnom trgu okruženom s impresivnim građevinama i štandovima trgovaca. Oko tebe se nalaze Akropola, Gimnazij, Hram i Teatar.

Jedan promišljeni filozof šeta oko sebe raspravljajući sam sa sobom.

Nalaziš se u središtu Agore, u srcu Grčkog Polisa.

>look
Agora
Vi stojite u središtu Agore, živahnom trgu okruženom s impresivnim građevinama i štandovima trgovaca.

>look at Agora
You see nothing special about the Agora.

>look Agora
You see nothing special about the Agora.

>up
You can't go that way.

>down
You can't go that way.

* * *

>look
Agora
Vi stojite u središtu Agore, živahnom trgu okruženom s impresivnim građevinama i štandovima trgovaca.

>north
Akropola
Akropola, smještena na visokoj stijeni, dominira gradskim krajolikom.

Statua veličanstvenog grčkog boga gleda nad gradom.

* * *

>eksperimentiraj
O ne! Eksperiment je pošao po krivu, aktivirala si vremenski portal. Odjednom svijet oko tebe izgleda drugačije. 
Agora
Stojiš u središtu Agore, živahnom trgu okruženom s impresivnim građevinama i štandovima trgovaca. Oko tebe se nalaze Akropola, Gimnazij, Hram i Teatar.

Jedan promišljeni filozof šeta oko sebe raspravljajući sam sa sobom.

Nalaziš se u središtu Agore, u srcu Grčkog Polisa.

>razgovaraj s filozof
Razgovaš s filozofom. Možeš "razmisliti o univerzumu", "razgovarati o zivotu", ili "pitati za savjet".

>north
Akropola
Akropola, smještena na visokoj stijeni, dominira gradskim krajolikom.

Statua veličanstvenog grčkog boga gleda nad gradom.

Oštro oko vojnika nadzire grad iz svoje visoke pozicije.

>razgovaraj s vojnik
Vojnik kratko spušta svoj pogled s horizonta i govori o bitkama koje je vidio.

>south
Agora
Vi stojite u središtu Agore, živahnom trgu okruženom s impresivnim građevinama i štandovima trgovaca.

Jedan promišljeni filozof šeta oko sebe raspravljajući sam sa sobom.

>e
Gimnazij
Ovo je gimnazij, mjesto gdje se mladići obučavaju i educiraju.

Mladi učenik vježba atletiku, povremeno zastajući da zapita svoje učitelje.

>look templo
You can't see any such thing.

>look gimnazij
You can't see any such thing.

>look Gimnazij
You can't see any such thing.

>touch statue
You can't see any such thing.

* * *

>razgovaraj s filozof
Razgovaš s filozofom. Možeš "razmisliti o univerzumu", "razgovarati o zivotu", ili "pitati za savjet".

>e
Gimnazij
Ovo je gimnazij, mjesto gdje se mladići obučavaju i educiraju.

Mladi učenik vježba atletiku, povremeno zastajući da zapita svoje učitelje.

>razgovaraj s ucenik
You can't see any such thing.

>razgovaraj s učenik
You can't see any such thing.

>razgovaraj s učenik
You can't see any such thing.

>look Gimnazij
You can't see any such thing.

>look
Gimnazij
Ovo je gimnazij, mjesto gdje se mladići obučavaju i educiraju.

Mladi učenik vježba atletiku, povremeno zastajući da zapita svoje učitelje.

>w
Agora
Vi stojite u središtu Agore, živahnom trgu okruženom s impresivnim građevinama i štandovima trgovaca.

Jedan promišljeni filozof šeta oko sebe raspravljajući sam sa sobom.

>w
Teatar
Teatar je mjesto gdje se održavaju dramske predstave i javni govori.

Jedan glumac, odjeven u dramatičnu kostimografiju, uvježbava svoje replike.

>razgovaraj s glumac
Glumac s oduševljenjem izvodi monolog iz svoje najnovije drame.

>e
Agora
Vi stojite u središtu Agore, živahnom trgu okruženom s impresivnim građevinama i štandovima trgovaca.

Jedan promišljeni filozof šeta oko sebe raspravljajući sam sa sobom.

>n
Akropola
Akropola, smještena na visokoj stijeni, dominira gradskim krajolikom.

Statua veličanstvenog grčkog boga gleda nad gradom.

Oštro oko vojnika nadzire grad iz svoje visoke pozicije.

>razgovaraj s vojnik
Vojnik nadzirajući grad govori o bitkama koje je vidio te o tome kako Posejdonoc trozubac ima posebne moci.

>examine Posejdon
Kip prikazuje Posejdona, božanstvo mora, s trozubcom u ruci.

>dotakni Posejdon
Kako vaši prsti dodiruju hladan kamen statue, svijet oko vas se počinje vrtjeti!

Trg
Vi stojite na središnjem trgu Srednjovjekovnog Grada, okruženi srednjovjekovnim zdanjima i živahnom gužvom.

>n
You can't go that way.

* * *

>razgovaraj s filozof
Razgovaš s filozofom. Možeš "razmisliti o univerzumu", "razgovarati o zivotu", ili "pitati za savjet".

>pitaj za savjet
Filozof nudi mudar savjet koji bi ti mogao pomoći na tvom putovanju.

>razmisli o univerzumu
Filozof s oduševljenjem raspravlja o teorijama o univerzumu.

>e
Napravili ste 1 koraka.

Gimnazij
Ovo je gimnazij, mjesto gdje se mladići obučavaju i educiraju.

Mladi učenik vježba atletiku, povremeno zastajući da zapita svoje učitelje.

* * *

>razgovaraj s filozof
Razgovaš s filozofom. Možeš "razmisliti o univerzumu", "razgovarati o zivotu", ili "pitati za savjet".

>razmisli o univerzumu
Filozof s oduševljenjem raspravlja o teorijama o univerzumu.

>pitaj za savjet
Filozof nudi mudar savjet koji bi ti mogao pomoći na tvom putovanju. Savjetuje ići na Akropolu i razgovarati s vojnikom.

>w
Napravili ste 1 koraka.

Teatar
Teatar je mjesto gdje se održavaju dramske predstave i javni govori.

 Vidiš glumca, odjevenog u dramatičnu kostimografiju, koji uvježbava svoje tekstove.

>e
Napravili ste 2 koraka.

Agora
Stojiš u središtu Agore, živahnom trgu okruženom s impresivnim građevinama i štandovima trgovaca. Oko tebe se nalaze Akropola, Gimnazij, Hram i Teatar.

Jedan promišljeni filozof šeta oko sebe raspravljajući sam sa sobom.

>s
Napravili ste 3 koraka.

Hram
Posvećen bogovima, Hram je mjesto molitve i žrtvovanja.

Svećenik, duboko uronjen u molitvu, stoji pred oltarom.

>n
Napravili ste 4 koraka.

Agora
Stojiš u središtu Agore, živahnom trgu okruženom s impresivnim građevinama i štandovima trgovaca. Oko tebe se nalaze Akropola, Gimnazij, Hram i Teatar.

Jedan promišljeni filozof šeta oko sebe raspravljajući sam sa sobom.

>n
Napravili ste 5 koraka.

Akropola
Akropola, smještena na visokoj stijeni, dominira gradskim krajolikom.

Kip veličanstvenog grčkog boga Posejdona gleda nad gradom.

Oštro oko vojnika nadzire grad iz svoje visoke pozicije.

>razgovaraj s vojnik
Vojnik nadzirajući grad govori ti o bitkama te o tome kako je vidio da Posejdonov trozubac ima posebne moci.

>look
Akropola
Akropola, smještena na visokoj stijeni, dominira gradskim krajolikom.

Kip veličanstvenog grčkog boga Posejdona gleda nad gradom.

Oštro oko vojnika nadzire grad iz svoje visoke pozicije.

>examine Posejdon
Kip prikazuje Posejdona, božanstvo mora, s trozubcem u ruci.

>dotakni Posejdon
Kako tvoji prsti dodiruju hladan kamen statue, svijet oko tebe se počinje vrtjeti....

Trg
Odjednom stojiš na središnjem trgu Srednjovjekovnog Grada, okruženom srednjovjekovnim zidinama i živahnom gužvom. Oko tebe se nalaze Katedrala, Dvorac, Krcma i Trznica.

>s
Napravili ste 6 koraka.

Krcma
Topla i bučna krčma, puna lokalnih stanovnika i putnika. Zidovi su ukrašeni raznobojnim zastavama i oružjem.

Veseli krčmar, poznat po svojim pričama i dobrom pivu, srdačno dočekuje svakog gosta.

>razgovaraj s krcmar
Krčmar s veseljem dijeli priče o svojim avanturama i tajnama koje su mu putnici ispričali. Spomene da je potrebna sreca za posjet tim zemljama, koja se dobije tako da se zapali svijeća u vrtu Dvorca.

>n
Napravili ste 7 koraka.

Trg
Odjednom stojiš na središnjem trgu Srednjovjekovnog Grada, okruženom srednjovjekovnim zidinama i živahnom gužvom. Oko tebe se nalaze Katedrala, Dvorac, Krcma i Trznica.

>w
Napravili ste 8 koraka.

Trznica
Bujna tržnica prepuna štandova koji prodaju sve od hrane do tkanina. Trgovci dozivaju prolaznike, nudeći svoju robu.

Vješt trgovac, uvijek spreman na pregovaranje, nudi razne robe putnicima i mještanima.

You can also see Svijeca here.

>razgovaraj s trgovac
Trgovac ti pokazuje svoju najnoviju robu, i priča o dalekim zemljama odakle dolaze.

>kupi svijeca
Trgovac ti prodaje svijeću za nekoliko novčića.

>inventory
You are carrying:
  Svijeca

>e
Napravili ste 9 koraka.

Trg
Odjednom stojiš na središnjem trgu Srednjovjekovnog Grada, okruženom srednjovjekovnim zidinama i živahnom gužvom. Oko tebe se nalaze Katedrala, Dvorac, Krcma i Trznica.

>e
Napravili ste 10 koraka.

Dvorac
Impresivan dvorac s debelim zidovima i visokim kulama. Ovo je sjedište moći i upravljanja u gradu.

Sluga, diskretan i pažljiv, brižno pazi na sve potrebe dvorskog osoblja i posjetitelja.

>razgovaraj s sluga
Sluga ti priča o dvorskim dogadanjima.

* * *

>razmisli o univerzumu
Filozof s oduševljenjem raspravlja o teorijama o univerzumu.

>n
Napravili ste 1 koraka.

Akropola
Akropola, smještena na visokoj stijeni, dominira gradskim krajolikom.

Kip veličanstvenog grčkog boga Posejdona gleda nad gradom.

Oštro oko vojnika nadzire grad iz svoje visoke pozicije.

>dotakni posejdon
Kako tvoji prsti dodiruju hladan kamen statue, svijet oko tebe se počinje vrtjeti....

Trg
Odjednom stojiš na središnjem trgu Srednjovjekovnog Grada, okruženom srednjovjekovnim zidinama i živahnom gužvom. Oko tebe se nalaze Katedrala, Dvorac, Krcma i Trznica.

>s
Napravili ste 2 koraka.

Krcma
Topla i bučna krčma, puna lokalnih stanovnika i putnika. Zidovi su ukrašeni raznobojnim zastavama i oružjem.

Veseli krčmar, poznat po svojim pričama i dobrom pivu, srdačno dočekuje svakog gosta.

>n
Napravili ste 3 koraka.

Trg
Odjednom stojiš na središnjem trgu Srednjovjekovnog Grada, okruženom srednjovjekovnim zidinama i živahnom gužvom. Oko tebe se nalaze Katedrala, Dvorac, Krcma i Trznica.

>e
Napravili ste 4 koraka.

Dvorac
Impresivan dvorac s debelim zidovima i visokim kulama. Ovo je sjedište moći i upravljanja u gradu. Istočno od dvorca nalazi se velik vrt sa mnogo šarenog cvijeća i raznolikog bilja.

Sluga, diskretan i pažljiv, brižno pazi na sve potrebe dvorskog osoblja i posjetitelja.

>w
Napravili ste 5 koraka.

Trg
Odjednom stojiš na središnjem trgu Srednjovjekovnog Grada, okruženom srednjovjekovnim zidinama i živahnom gužvom. Oko tebe se nalaze Katedrala, Dvorac, Krcma i Trznica.

>w
Napravili ste 6 koraka.

Trznica
Bujna tržnica prepuna štandova koji prodaju sve od hrane do tkanina. Trgovci dozivaju prolaznike, nudeći svoju robu.

Vješt trgovac, uvijek spreman na pregovaranje, nudi razne robe putnicima i mještanima.

You can also see Svijeca here.

>kupi svijeca
Trgovac ti prodaje svijeću za nekoliko novčića.

* * *

>inventory
You are carrying:
  Svijeca

>kupi svijeca
Već imaš svijeću.

>e
Napravili ste 7 koraka.

Trg
Odjednom stojiš na središnjem trgu Srednjovjekovnog Grada, okruženom srednjovjekovnim zidinama i živahnom gužvom. Oko tebe se nalaze Katedrala, Dvorac, Krcma i Trznica.

>e
Napravili ste 8 koraka.

Dvorac
Impresivan dvorac s debelim zidovima i visokim kulama. Ovo je sjedište moći i upravljanja u gradu. Istočno od dvorca nalazi se velik vrt sa mnogo šarenog cvijeća i raznolikog bilja.

Sluga, diskretan i pažljiv, brižno pazi na sve potrebe dvorskog osoblja i posjetitelja.

>e
Napravili ste 9 koraka.

Vrt
Vrt Dvorca je mirno i lijepo uređeno mjesto, savršeno za razmišljanje ili tajne sastanke.

>zapali svijeca
Pališ svijeću, a kako plamen titra, prostor oko tebe se počinje mijenjati...

Glavni Trg
Nalaziš se na Glavnom Trgu u Novovjekovnom Gradu. To je živahno mjesto, s modernijim zgradama i šarenim svjetlima. Oko tebe se nalaze Gradski Park, Muzej, Stravična Kuća i KavanaLena se odjednom .

>n
Napravili ste 10 koraka.

Gradski Park
Prostrani zeleni park, idealno mjesto za odmor i uživanje u prirodi.

Šetač, lokalni stanovnik koji uživa u miru parka, rado će podijeliti najnovije tračeve i priče grada.

>s
Napravili ste 11 koraka.

Glavni Trg
Nalaziš se na Glavnom Trgu u Novovjekovnom Gradu. To je živahno mjesto, s modernijim zgradama i šarenim svjetlima. Oko tebe se nalaze Gradski Park, Muzej, Stravična Kuća i KavanaLena se odjednom .

>e
Napravili ste 12 koraka.

Muzej
Muzej prepun povijesnih eksponata koji pričaju priču o gradu i njegovim tajnama.

Cuvar, strastveni čuvar povijesti grada u muzeju, brižno se brine o svakom eksponatu.

You can also see Futuristika oprema here.

>istrazi muzej
Prolaziš kroz muzej, promatrajući razne eksponate. Osim povijesnih artefakata, primjećuješ nekoliko predmeta koji izgledaju kao da pripadaju budućnosti. Točnije vidiš futurističku opremu sličnu tvojoj u laboratoriju.

>koristi opremu
Pregledavaš i koristiš futurističku opremu. Čudesno, ona počinje isijavati svjetlost i emitirati zvukove. Oko tebe se počinje formirati portal!

Laboratorij
Dorbodošli u laboratorij znanstvenice Lene. 

Prošavši kroz portal, nalaziš se u poznatom okruženju.

    *** Kraj igre - Lena se uspješno vratila u sadašnjost. ***

Would you like to RESTART, RESTORE a saved game, QUIT or UNDO the last command?

* * *

>eksperimentiraj
O ne! Eksperiment je pošao po krivu, aktivirala si vremenski portal. Odjednom svijet oko tebe izgleda drugačije. 
Agora
Stojiš u središtu Agore, živahnom trgu okruženom s impresivnim građevinama i štandovima trgovaca. Oko tebe se nalaze Akropola, Gimnazij, Hram i Teatar.

Jedan promišljeni filozof šeta oko sebe raspravljajući sam sa sobom.

Nalaziš se u središtu Agore, u srcu Grčkog Polisa.

>w
Napravili ste 1 koraka.

Teatar
Teatar je mjesto gdje se održavaju dramske predstave i javni govori.

 Vidiš glumca, odjevenog u dramatičnu kostimografiju, koji uvježbava svoje tekstove.

>e
Nakon dugog putovanja i 30 koraka, vaša avantura dolazi do kraja.

    *** Kraj igre - postigli ste 30 koraka ***

Would you like to RESTART, RESTORE a saved game, QUIT or UNDO the last command?

>n
Akropola
Akropola, smještena na visokoj stijeni, dominira gradskim krajolikom.

Statua veličanstvenog grčkog boga gleda nad gradom.

Oštro oko vojnika nadzire grad iz svoje visoke pozicije.

* * *

>razgovaraj s vojnik
Vojnik nadzirajući grad govori o bitkama koje je vidio te o tome kako Posejdonoc trozubac ima posebne moci.

>look akropola
You can't see any such thing.

>look
Akropola
Akropola, smještena na visokoj stijeni, dominira gradskim krajolikom.

Statua veličanstvenog grčkog boga gleda nad gradom.

Oštro oko vojnika nadzire grad iz svoje visoke pozicije.

>dotakni Posejdon
Kako vaši prsti dodiruju hladan kamen statue, svijet oko vas se počinje vrtjeti!

Trg
Vi stojite na središnjem trgu Srednjovjekovnog Grada, okruženi srednjovjekovnim zidinama i živahnom gužvom.

>n
Katedrala
Velika katedrala s visokim tornjevima i vitražima dominira gradskim krajolikom. Unutrašnjost je tiha i puna osjećaja strahopoštovanja.

Biskup, odjeven u svečane halje, ozbiljno obavlja svoje dužnosti.

>razgovaraj s biskup
Biskup vas blagoslovi i govori o važnosti vjere u teškim vremenima, suosjeća s Lenom da se osjeca izgubljeno

>s
Trg
Vi stojite na središnjem trgu Srednjovjekovnog Grada, okruženi srednjovjekovnim zidinama i živahnom gužvom.

>w
Trznica
Bujna tržnica prepuna štandova koji prodaju sve od hrane do tkanina. Trgovci dozivaju prolaznike, nudeći svoje robe.

Vješt trgovac, uvijek spreman na pregovaranje, nudi razne robe putnicima i mještanima.

You can also see Svijeca here.

>kupi svijeca
Trgovac vam prodaje svijeću za nekoliko novčića.

>inventory
You are carrying:
  Svijeca

>e
Trg
Vi stojite na središnjem trgu Srednjovjekovnog Grada, okruženi srednjovjekovnim zidinama i živahnom gužvom.

>s
Krcma
Topla i bučna krčma, puna lokalnih stanovnika i putnika. Zidovi su ukrašeni raznobojnim zastavama i oružjem.

Veseli krčmar, poznat po svojim pričama i dobrom pivu, srdačno dočekuje svakog gosta.

>razgovaraj s krcmar
Krčmar s veseljem dijeli priče o svojim avanturama i tajnama koje su mu putnici ispričali. Spomene da je potrebna sreca za posjet tim zemljama, koja se dobije tako da se zapali svijeća u vrtu Dvorca.

>n
Trg
Vi stojite na središnjem trgu Srednjovjekovnog Grada, okruženi srednjovjekovnim zidinama i živahnom gužvom.

>e
Dvorac
Impresivan dvorac s debelim zidovima i visokim kulama. Ovo je sjedište moći i upravljanja u gradu.

Sluga, diskretan i pažljiv, brižno pazi na sve potrebe dvorskog osoblja i posjetitelja.

>e
Vrt
Vrt Dvorca je mirno i lijepo uređeno mjesto, savršeno za razmišljanje ili tajne sastanke.

>zapali svijeca
Palite svijeću, a kako plamen titra, prostor oko vas počinje se mijenjati...

Glavni Trg in Novovjekovni Grad
Glavni Trg u Novovjekovnom Gradu je živahno mjesto, s modernijim zgradama i šarenim svjetlima.

>s
Stravicna kuca
Tajanstvena kuća za koju se priča da je dom lokalnih vještica, puna čarolija i misterija.

Mudra i tajanstvena vještica, poznata po svojim čarobnim napicima i proročkim sposobnostima.

>razgovaraj s vjestica
Vještica vam šapće tajne starog grada i dijeli mudrost o skrivenim čarolijama.

* * *

>w
Napravili ste 1 koraka.

Teatar
Teatar je mjesto gdje se održavaju dramske predstave i javni govori.

 Vidiš glumca, odjevenog u dramatičnu kostimografiju, koji uvježbava svoje tekstove.

>look
Teatar
Teatar je mjesto gdje se održavaju dramske predstave i javni govori.

Jedan glumac, odjeven u dramatičnu kostimografiju, uvježbava svoje tekstove.

>take
(the glumac)
I don't suppose the glumac would care for that.

>e
Agora
Stojiš u središtu Agore, živahnom trgu okruženom s impresivnim građevinama i štandovima trgovaca.

Jedan promišljeni filozof šeta oko sebe raspravljajući sam sa sobom.

>w
Teatar
Teatar je mjesto gdje se održavaju dramske predstave i javni govori.

Jedan glumac, odjeven u dramatičnu kostimografiju, uvježbava svoje tekstove.

>w
You can't go that way.

>e
Agora
Stojiš u središtu Agore, živahnom trgu okruženom s impresivnim građevinama i štandovima trgovaca.

Jedan promišljeni filozof šeta oko sebe raspravljajući sam sa sobom.

>n
Akropola
Akropola, smještena na visokoj stijeni, dominira gradskim krajolikom.

Statua veličanstvenog grčkog boga gleda nad gradom.

Oštro oko vojnika nadzire grad iz svoje visoke pozicije.

>razgovaraj s ucenik
You can't see any such thing.

>razgovaraj s bhfi
You can't see any such thing.

>razgovaraj s vojnik
Vojnik nadzirajući grad govori o bitkama te o tome kako je vidio da Posejdonov trozubac ima posebne moci.

>dotakni Posejdon
Kako moji prsti dodiruju hladan kamen statue, svijet oko mene se počinje vrtjeti!

Trg
Stojiš na središnjem trgu Srednjovjekovnog Grada, okruženom srednjovjekovnim zidinama i živahnom gužvom.

>s
Krcma
Topla i bučna krčma, puna lokalnih stanovnika i putnika. Zidovi su ukrašeni raznobojnim zastavama i oružjem.

Veseli krčmar, poznat po svojim pričama i dobrom pivu, srdačno dočekuje svakog gosta.

* * *

>razgovaraj s krcmar
Krčmar s veseljem dijeli priče o svojim avanturama i tajnama koje su mu putnici ispričali. Spomene da je potrebna sreca za posjet tim zemljama, koja se dobije tako da se zapali svijeća u vrtu Dvorca.

>n
Trg
Stojiš na središnjem trgu Srednjovjekovnog Grada, okruženom srednjovjekovnim zidinama i živahnom gužvom.

>w
Trznica
Bujna tržnica prepuna štandova koji prodaju sve od hrane do tkanina. Trgovci dozivaju prolaznike, nudeći svoju robu.

Vješt trgovac, uvijek spreman na pregovaranje, nudi razne robe putnicima i mještanima.

You can also see Svijeca here.

>razgovaraj s trgovac
Trgovac mi pokazuje svoju najnoviju robu, i priča o dalekim zemljama odakle dolaze.

>kupi svijeca
Trgovac mi prodaje svijeću za nekoliko novčića.

>kupi svijeca
Već imaš svijeću.

>inventory
You are carrying:
  Svijeca

>e
Trg
Stojiš na središnjem trgu Srednjovjekovnog Grada, okruženom srednjovjekovnim zidinama i živahnom gužvom.

>e
Dvorac
Impresivan dvorac s debelim zidovima i visokim kulama. Ovo je sjedište moći i upravljanja u gradu.

Sluga, diskretan i pažljiv, brižno pazi na sve potrebe dvorskog osoblja i posjetitelja.

>razgovaraj s sluga
Sluga mi priča o dvorskim dogadanjima.

>e
Vrt
Vrt Dvorca je mirno i lijepo uređeno mjesto, savršeno za razmišljanje ili tajne sastanke.

>zapali svijeca
Palim svijeću, a kako plamen titra, prostor oko mene se počinje mijenjati...

Glavni Trg
Glavni Trg u Novovjekovnom Gradu je živahno mjesto, s modernijim zgradama i šarenim svjetlima.

>n
Gradski Park
Prostrani zeleni park, idealno mjesto za odmor i uživanje u prirodi.

Šetač, lokalni stanovnik koji uživa u miru parka, rado će podijeliti najnovije tračeve i priče grada.

>razgovaraj s setac
Šetač mi priča o promjenama koje je vidio u parku i gradu tijekom godina.

>s
Glavni Trg
Glavni Trg u Novovjekovnom Gradu je živahno mjesto, s modernijim zgradama i šarenim svjetlima.

>e
Muzej
Muzej prepun povijesnih eksponata koji pričaju priču o gradu i njegovim tajnama.

Kustos, strastveni čuvar povijesti grada, brižno se brine o svakom eksponatu.

>w
Glavni Trg
Glavni Trg u Novovjekovnom Gradu je živahno mjesto, s modernijim zgradama i šarenim svjetlima.

>s
Stravicna kuca
Tajanstvena kuća za koju se priča da je dom lokalnih vještica, puna čarolija i misterija.

Mudra i tajanstvena vještica, poznata po svojim čarobnim napicima i proročkim sposobnostima.

Misteriozan napitak koji isijava čudnim sjajem, kao da pulsira sa drevnom energijom.

>razgovaraj s vjestica
Vještica mi šapće tajne starog grada i dijeli mudrost o skrivenim čarolijama. Daje mi napitak za koji obećava da će me vratiti u sadašnje vrijeme.

>uzimanje
That's not a verb I recognise.

>uzimanje napitka
That's not a verb I recognise.

>uzmi napitak
Pažljivo uzimas napitak, osjećajući kako ti ruke blago drhte od uzbuđenja i straha.

Čim je napitak dotaknuo tvoje usne, svijet oko tebe se počinje vrtjeti nevjerojatnom brzinom. Kada se tvoj vid konačno razbistri, nalaziš se u potpuno drugačijem svijetu...

Neandertalsko Doba
Našli ste se u neandertalskom dobu, okruženi prapovijesnom prirodom s visokim drvećem i zvukovima divljih životinja. Izgleda da ste se vratili unatrag u vrijeme.

Dok se prilagođavaš novom okruženju, shvaćate da si se vratila unazad u vremenu, u doba Neandertalaca. Ovdje, u ovom primitivnom i divljem svijetu, ne znaš kako bi se ponašala te ubrzo shvatiš da je tvom putovanju došao kraj

    *** Kraj igre - Putovala si predaleko u vrijeme da bi prezivjela. ***

Would you like to RESTART, RESTORE a saved game, QUIT or UNDO the last command?

>undo
Stravicna kuca
[Previous turn undone.]

>nemoj uzeti napitak
Odlučuješ da je bolje ne riskirati s misterioznim napitkom. Tko zna kakve bi posljedice to moglo imati...

>n
Glavni Trg
Glavni Trg u Novovjekovnom Gradu je živahno mjesto, s modernijim zgradama i šarenim svjetlima.

>e
Muzej
Muzej prepun povijesnih eksponata koji pričaju priču o gradu i njegovim tajnama.

Kustos, strastveni čuvar povijesti grada, brižno se brine o svakom eksponatu.

* * *

>eksperimentiraj
O ne! Eksperiment je pošao po krivu, aktivirala si vremenski portal. Odjednom svijet oko tebe izgleda drugačije. 
Agora
Stojiš u središtu Agore, živahnom trgu okruženom s impresivnim građevinama i štandovima trgovaca. Oko tebe se nalaze Akropola, Gimnazij, Hram i Teatar.

Jedan promišljeni filozof šeta oko sebe raspravljajući sam sa sobom.

Nalaziš se u središtu Agore, u srcu Grčkog Polisa.

>e
Napravili ste 1 koraka.

Gimnazij
Ovo je gimnazij, mjesto gdje se mladići obučavaju i educiraju.

Mladi učenik vježba atletiku, povremeno zastajući da zapita svoje učitelje.

>w
Napravili ste 2 korak/a.

>n
Napravili ste 3 korak/a.

* * *

>e
Napravili ste 1 koraka.

Gimnazij
Ovo je gimnazij, mjesto gdje se mladići obučavaju i educiraju.

Mladi učenik vježba atletiku, povremeno zastajući da zapita svoje učitelje.

>e
You can't go that way.

>w
Nakon dugog putovanja i 30 koraka, tvoje putovanje po vremenskim dimenzijama dolazi do kraja.

    *** Kraj igre - predugo si se kretala po drugim dimenzijama ***

Would you like to RESTART, RESTORE a saved game, QUIT or UNDO the last command?

* * *

>eksperimentiraj
O ne! Eksperiment je pošao po krivu, aktivirala si vremenski portal. Odjednom svijet oko tebe izgleda drugačije. 
Agora
Stojiš u središtu Agore, živahnom trgu okruženom s impresivnim građevinama i štandovima trgovaca. Oko tebe se nalaze Akropola, Gimnazij, Hram i Teatar.

Jedan promišljeni filozof šeta oko sebe raspravljajući sam sa sobom.

Nalaziš se u središtu Agore, u srcu Grčkog Polisa.

>razvovaraj s filozofom
That's not a verb I recognise.

* * *

>eksperimentiraj
O ne! Eksperiment je pošao po krivu, aktivirala si vremenski portal. Odjednom svijet oko tebe izgleda drugačije. 
Agora
Stojiš u središtu Agore, živahnom trgu okruženom s impresivnim građevinama i štandovima trgovaca. Oko tebe se nalaze Akropola, Gimnazij, Hram i Teatar.

Jedan promišljeni filozof šeta oko sebe raspravljajući sam sa sobom.

Nalaziš se u središtu Agore, u srcu Grčkog Polisa.

>s
Napravili ste 1 koraka.

Hram
Posvećen bogovima, Hram je mjesto molitve i žrtvovanja.

Svećenik, duboko uronjen u molitvu, stoji pred oltarom.

>razgovaraj s svecenik
Svećenik te blagoslivlja i govori o važnosti bogova u svakodnevnom životu.

>razgovaraj s jikl
You can't see any such thing.

>n
Napravili ste 2 koraka.

Agora
Stojiš u središtu Agore, živahnom trgu okruženom s impresivnim građevinama i štandovima trgovaca. Oko tebe se nalaze Akropola, Gimnazij, Teatar i Hram.

Jedan promišljeni filozof šeta oko sebe raspravljajući sam sa sobom.

>w
Napravili ste 3 koraka.

Teatar
Teatar je mjesto gdje se održavaju dramske predstave i javni govori.

 Vidiš glumca, odjevenog u dramatičnu kostimografiju, koji uvježbava svoje tekstove.

>razgovaraj s glumac
Glumac s oduševljenjem izvodi monolog iz svoje najnovije drame.

>e
Napravili ste 4 koraka.

Agora
Stojiš u središtu Agore, živahnom trgu okruženom s impresivnim građevinama i štandovima trgovaca. Oko tebe se nalaze Akropola, Gimnazij, Teatar i Hram.

Jedan promišljeni filozof šeta oko sebe raspravljajući sam sa sobom.

>razgovaraj s filozof
Razgovaš s filozofom. Možeš "razmisliti o univerzumu", "razgovarati o zivotu", ili "pitati za savjet".

* * *

>razmisli o univerzumu
Filozof s oduševljenjem raspravlja o teorijama o univerzumu.

>razgovarati o zivotu
Filozof dijeli svoje mišljenje o značenju i svrsi života.

>pitaj za savjet
Filozof nudi mudar savjet koji bi ti mogao pomoći na tvom putovanju. Savjetuje ići na Akropolu

>n
Napravili ste 5 koraka.

Akropola
Akropola, smještena na visokoj stijeni, dominira gradskim krajolikom.

Kip veličanstvenog grčkog boga Posejdona gleda nad gradom.

Oštro oko vojnika nadzire grad iz svoje visoke pozicije.

>razgovaraj s vojnikom
You can't see any such thing.

>razgovaraj s vojnik
Vojnik nadzirajući grad govori ti o bitkama te o tome kako je vidio da Posejdonov trozubac ima posebne moci.

* * *

>look
Akropola
Akropola, smještena na visokoj stijeni, dominira gradskim krajolikom.

Kip veličanstvenog grčkog boga Posejdona gleda nad gradom.

Oštro oko vojnika nadzire grad iz svoje visoke pozicije.

>dotakni Posejdon
Kako tvoji prsti dodiruju hladan kamen statue, svijet oko tebe se počinje vrtjeti....

Trg
Odjednom stojiš na središnjem trgu Srednjovjekovnog Grada, okruženom srednjovjekovnim zidinama i živahnom gužvom. Oko tebe se nalaze Katedrala, Dvorac, Trznica i Krcma.

>undo
Akropola
[Previous turn undone.]

>look
Akropola
Akropola, smještena na visokoj stijeni, dominira gradskim krajolikom.

Kip veličanstvenog grčkog boga Posejdona gleda nad gradom.

Oštro oko vojnika nadzire grad iz svoje visoke pozicije.

* * *

>examine Posejdon
Kip prikazuje Posejdona, božanstvo mora, s trozubcem u ruci.

>dotakni posejdon
Kako tvoji prsti dodiruju hladan kamen statue, svijet oko tebe se počinje vrtjeti....

Trg
Odjednom stojiš na središnjem trgu Srednjovjekovnog Grada, okruženom srednjovjekovnim zidinama i živahnom gužvom. Oko tebe se nalaze Katedrala, Dvorac, Trznica i Krcma.

>n
Napravili ste 6 koraka.

Katedrala
Velika katedrala s visokim tornjevima i vitražima dominira gradskim krajolikom. Unutrašnjost je tiha i puna osjećaja strahopoštovanja.

Biskup, odjeven u svečane halje, ozbiljno obavlja svoje dužnosti.

>razgovaraj s biskup
Biskup te blagoslovi i govori o važnosti vjere u teškim vremenima, te suosjeća sa mnom da se osjecam izgubljeno

>s
Napravili ste 7 koraka.

Trg
Odjednom stojiš na središnjem trgu Srednjovjekovnog Grada, okruženom srednjovjekovnim zidinama i živahnom gužvom. Oko tebe se nalaze Katedrala, Dvorac, Trznica i Krcma.

>w
Napravili ste 8 koraka.

Trznica
Bujna tržnica prepuna štandova koji prodaju sve od hrane do tkanina. Trgovci dozivaju prolaznike, nudeći svoju robu.

Vješt trgovac, uvijek spreman na pregovaranje, nudi razne robe putnicima i mještanima.

You can also see Svijeca here.

>e
Napravili ste 9 koraka.

Trg
Odjednom stojiš na središnjem trgu Srednjovjekovnog Grada, okruženom srednjovjekovnim zidinama i živahnom gužvom. Oko tebe se nalaze Katedrala, Dvorac, Trznica i Krcma.

>s
Napravili ste 10 koraka.

Krcma
Topla i bučna krčma, puna lokalnih stanovnika i putnika. Zidovi su ukrašeni raznobojnim zastavama i oružjem.

Veseli krčmar, poznat po svojim pričama i dobrom pivu, srdačno dočekuje svakog gosta.

>razgovaraj s krcmar
Krčmar s veseljem dijeli priče o svojim avanturama i tajnama koje su mu putnici ispričali. Spomene da je potrebna sreca za posjet tim zemljama, koja se dobije tako da se zapali svijeća u vrtu Dvorca.

>n
Napravili ste 11 koraka.

Trg
Odjednom stojiš na središnjem trgu Srednjovjekovnog Grada, okruženom srednjovjekovnim zidinama i živahnom gužvom. Oko tebe se nalaze Katedrala, Dvorac, Trznica i Krcma.

>w
Napravili ste 12 koraka.

Trznica
Bujna tržnica prepuna štandova koji prodaju sve od hrane do tkanina. Trgovci dozivaju prolaznike, nudeći svoju robu.

Vješt trgovac, uvijek spreman na pregovaranje, nudi razne robe putnicima i mještanima.

You can also see Svijeca here.

>razgovaraj s trgovac
Trgovac ti pokazuje svoju najnoviju robu, i priča o dalekim zemljama odakle dolaze.

* * *

>kupi svijeca
Trgovac ti prodaje svijeću za nekoliko novčića.

>kupnja
That's not a verb I recognise.

>kupi svijeca
Već imaš svijeću.

* * *

>inventory
You are carrying:
  Svijeca

>e
Napravili ste 13 koraka.

Trg
Odjednom stojiš na središnjem trgu Srednjovjekovnog Grada, okruženom srednjovjekovnim zidinama i živahnom gužvom. Oko tebe se nalaze Katedrala, Dvorac, Trznica i Krcma.

>e
Napravili ste 14 koraka.

Dvorac
Impresivan dvorac s debelim zidovima i visokim kulama. Ovo je sjedište moći i upravljanja u gradu.

Sluga, diskretan i pažljiv, brižno pazi na sve potrebe dvorskog osoblja i posjetitelja.

>razgovaraj s sluga
Sluga ti priča o dvorskim dogadanjima.

>e
Napravili ste 15 koraka.

Vrt
Vrt Dvorca je mirno i lijepo uređeno mjesto, savršeno za razmišljanje ili tajne sastanke.

>zapali svijeca
Pališ svijeću, a kako plamen titra, prostor oko tebe se počinje mijenjati...

Glavni Trg
Nalaziš se na Glavnom Trgu u Novovjekovnom Gradu. To je živahno mjesto, s modernijim zgradama i šarenim svjetlima.

>zapali sss
You can't see any such thing.

>undo
Glavni Trg
[Previous turn undone.]

>look
Glavni Trg
Nalaziš se na Glavnom Trgu u Novovjekovnom Gradu. To je živahno mjesto, s modernijim zgradama i šarenim svjetlima.

>look
Glavni Trg
Nalaziš se na Glavnom Trgu u Novovjekovnom Gradu. To je živahno mjesto, s modernijim zgradama i šarenim svjetlima.

>e
Napravili ste 16 koraka.

Muzej
Muzej prepun povijesnih eksponata koji pričaju priču o gradu i njegovim tajnama.

Cuvar, strastveni čuvar povijesti grada u muzeju, brižno se brine o svakom eksponatu.

Ovo je napredna futuristička oprema koju ste primijetili tijekom istraživanja muzeja.

>w
Napravili ste 17 koraka.

Glavni Trg
Nalaziš se na Glavnom Trgu u Novovjekovnom Gradu. To je živahno mjesto, s modernijim zgradama i šarenim svjetlima.

>w
Napravili ste 18 koraka.

Kavana
Elegantna kavana koja nudi raznovrsne delicije i osvježavajuća pića.

Konobar, ljubazan i efikasan, uvijek je spreman preporučiti najbolje slastice i napitke.

>razgovaraj s konobar
Konobar mi daje preporuke za najpopularnije kolače i pića u kavani.

>e
Napravili ste 19 koraka.

Glavni Trg
Nalaziš se na Glavnom Trgu u Novovjekovnom Gradu. To je živahno mjesto, s modernijim zgradama i šarenim svjetlima.

>n
Napravili ste 20 koraka.

Gradski Park
Prostrani zeleni park, idealno mjesto za odmor i uživanje u prirodi.

Šetač, lokalni stanovnik koji uživa u miru parka, rado će podijeliti najnovije tračeve i priče grada.

>razgovaraj s setac
Šetač ti priča o promjenama koje je vidio u parku i gradu tijekom godina.

>s
Napravili ste 21 koraka.

Glavni Trg
Nalaziš se na Glavnom Trgu u Novovjekovnom Gradu. To je živahno mjesto, s modernijim zgradama i šarenim svjetlima.

>s
Napravili ste 22 koraka.

Stravicna kuca
Tajanstvena kuća za koju se priča da je dom lokalnih vještica, puna čarolija i misterija.

Mudra i tajanstvena vještica, poznata po svojim čarobnim napicima i proročkim sposobnostima.

Vidiš misteriozan napitak koji isijava čudnim sjajem.

>razgovaraj s vjestica
Vještica ti šapće tajne starog grada i dijeli mudrost o skrivenim čarolijama. Daje ti napitak za koji obećava da će te vratiti u sadašnje vrijeme.

>uzmi napitak
Pažljivo uzimas napitak, osjećajući kako ti ruke blago drhte od uzbuđenja i straha.

Čim je napitak dotaknuo tvoje usne, svijet oko tebe se počinje vrtjeti nevjerojatnom brzinom. Kada se tvoj vid konačno razbistri, nalaziš se u potpuno drugačijem svijetu...

Neandertalsko Doba
Našli ste se u neandertalskom dobu, okruženi prapovijesnom prirodom s visokim drvećem i zvukovima divljih životinja. Izgleda da ste se vratili unatrag u vrijeme.

Dok se prilagođavaš novom okruženju, shvaćaš da si se vratila unazad u vremenu, u doba Neandertalaca. Ovdje, u ovom primitivnom i divljem svijetu, ne znaš kako bi se ponašala te ubrzo shvatiš da je tvom putovanju došao kraj

    *** Kraj igre - Lena je putovala predaleko u vrijeme da bi prezivjela. ***

Would you like to RESTART, RESTORE a saved game, QUIT or UNDO the last command?

>undo
Stravicna kuca
[Previous turn undone.]

>look
Stravicna kuca
Tajanstvena kuća za koju se priča da je dom lokalnih vještica, puna čarolija i misterija.

Mudra i tajanstvena vještica, poznata po svojim čarobnim napicima i proročkim sposobnostima.

Vidiš misteriozan napitak koji isijava čudnim sjajem.

>razgovaraj s vjesticom
You can't see any such thing.

>razgovaraj s vjestica
Vještica ti šapće tajne starog grada i dijeli mudrost o skrivenim čarolijama. Daje ti napitak za koji obećava da će te vratiti u sadašnje vrijeme.

>nemoj uzeti napitak
Odlučuješ da je bolje ne riskirati s misterioznim napitkom. Tko zna kakve bi posljedice to moglo imati...

>n
Napravili ste 23 koraka.

Glavni Trg
Nalaziš se na Glavnom Trgu u Novovjekovnom Gradu. To je živahno mjesto, s modernijim zgradama i šarenim svjetlima.

>e
Napravili ste 24 koraka.

Muzej
Muzej prepun povijesnih eksponata koji pričaju priču o gradu i njegovim tajnama.

Cuvar, strastveni čuvar povijesti grada u muzeju, brižno se brine o svakom eksponatu.

Ovo je napredna futuristička oprema koju ste primijetili tijekom istraživanja muzeja.

>razgovaraj s cuvar
Čuvar s oduševljenjem dijeli zanimljivosti o najdražim eksponatima u muzeju. Dijeli i informacije o tome kako su neki ljudi ušli u muzej i nikad nisu izašli.

>istrazi muzej
Prolaziš kroz muzej, promatrajući razne eksponate. Osim povijesnih artefakata, primjećuješ nekoliko predmeta koji izgledaju kao da pripadaju budućnosti. Točnije vidiš futurističku opremu sličnu tvojoj u laboratoriju

>koristi opremu
Pregledavaš i koristiš futurističku opremu. Čudesno, ona počinje isijavati svjetlost i emitirati zvukove. Oko tebe se počinje formirati portal!

Laboratorij
Dorbodošli u laboratorij znanstvenice Lene. U tijeku je eksperiment. 

Prošavši kroz portal, nalaziš se u poznatom okruženju.

    *** Kraj igre - Lena je uspješno vratila u sadašnjost. ***

Would you like to RESTART, RESTORE a saved game, QUIT or UNDO the last command?

* * *

>w
Napravili ste 1 koraka.

Teatar
Teatar je mjesto gdje se održavaju dramske predstave i javni govori.

 Vidiš glumca, odjevenog u dramatičnu kostimografiju, koji uvježbava svoje tekstove.

>e
Napravili ste 2 koraka.

Agora
Stojiš u središtu Agore, živahnom trgu okruženom s impresivnim građevinama i štandovima trgovaca. Oko tebe se nalaze Akropola, Gimnazij, Teatar i Hram.

Jedan promišljeni filozof šeta oko sebe raspravljajući sam sa sobom.

* * *

>eksperimentiraj
O ne! Eksperiment je pošao po krivu, aktivirala si vremenski portal. Odjednom svijet oko tebe izgleda drugačije. 
Agora
Stojiš u središtu Agore, živahnom trgu okruženom s impresivnim građevinama i štandovima trgovaca. Oko tebe se nalaze Akropola, Gimnazij, Hram i Teatar.

Jedan promišljeni filozof šeta oko sebe raspravljajući sam sa sobom.

Nalaziš se u središtu Agore, u srcu Grčkog Polisa.

>n
Napravili ste 1 koraka.

Akropola
Akropola, smještena na visokoj stijeni, dominira gradskim krajolikom.

Kip veličanstvenog grčkog boga Posejdona gleda nad gradom.

Oštro oko vojnika nadzire grad iz svoje visoke pozicije.

>dotakni Posejdon
Kako tvoji prsti dodiruju hladan kamen statue, svijet oko tebe se počinje vrtjeti....

Trg
Odjednom stojiš na središnjem trgu Srednjovjekovnog Grada, okruženom srednjovjekovnim zidinama i živahnom gužvom. Oko tebe se nalaze Katedrala, Dvorac, Krcma i Trznica.

>w
Napravili ste 2 koraka.

Trznica
Bujna tržnica prepuna štandova koji prodaju sve od hrane do tkanina. Trgovci dozivaju prolaznike, nudeći svoju robu.

Vješt trgovac, uvijek spreman na pregovaranje, nudi razne robe putnicima i mještanima.

You can also see Svijeca here.

>kupi svijeca
Trgovac ti prodaje svijeću za nekoliko novčića.

>e
Napravili ste 3 koraka.

Trg
Odjednom stojiš na središnjem trgu Srednjovjekovnog Grada, okruženom srednjovjekovnim zidinama i živahnom gužvom. Oko tebe se nalaze Katedrala, Dvorac, Krcma i Trznica.

>e
Napravili ste 4 koraka.

Dvorac
Impresivan dvorac s debelim zidovima i visokim kulama. Ovo je sjedište moći i upravljanja u gradu.

Sluga, diskretan i pažljiv, brižno pazi na sve potrebe dvorskog osoblja i posjetitelja.

* * *

>n
Napravili ste 1 koraka.

Akropola
Akropola, smještena na visokoj stijeni, dominira gradskim krajolikom.

Kip veličanstvenog grčkog boga Posejdona gleda nad gradom.

Oštro oko vojnika nadzire grad iz svoje visoke pozicije.

>dotakni posejdeon
You can't see any such thing.

>dotakni Posejdon
Kako tvoji prsti dodiruju hladan kamen statue, svijet oko tebe se počinje vrtjeti....

Trg
Odjednom stojiš na središnjem trgu Srednjovjekovnog Grada, okruženom srednjovjekovnim zidinama i živahnom gužvom. Oko tebe se nalaze Katedrala, Dvorac, Krcma i Trznica.

* * *

>e
Napravili ste 3 koraka.

Trg
Odjednom stojiš na središnjem trgu Srednjovjekovnog Grada, okruženom srednjovjekovnim zidinama i živahnom gužvom. Oko tebe se nalaze Katedrala, Dvorac, Krcma i Trznica.

>e
Napravili ste 4 koraka.

Dvorac
Impresivan dvorac s debelim zidovima i visokim kulama. Ovo je sjedište moći i upravljanja u gradu. Istočno od dvorca nalazi se velik vrt sa mnogo šarenog cvijeća i raznolikog bilja.

Sluga, diskretan i pažljiv, brižno pazi na sve potrebe dvorskog osoblja i posjetitelja.

>e
Napravili ste 5 koraka.

Vrt
Vrt Dvorca je mirno i lijepo uređeno mjesto, savršeno za razmišljanje ili tajne sastanke.

>zapali svijeca
Pališ svijeću, a kako plamen titra, prostor oko tebe se počinje mijenjati...

Glavni Trg
Nalaziš se na Glavnom Trgu u Novovjekovnom Gradu. To je živahno mjesto, s modernijim zgradama i šarenim svjetlima. Oko tebe se nalaze Gradski Park, Muzej, Stravična Kuća i Kavana,.

>s
Napravili ste 6 koraka.

Stravicna kuca
Tajanstvena kuća za koju se priča da je dom lokalnih vještica, puna čarolija i misterija.

Mudra i tajanstvena vještica, poznata po svojim čarobnim napicima i proročkim sposobnostima.

Vidiš misteriozan napitak koji isijava čudnim sjajem.

>razgovaraj s vjestica
Vještica ti šapće tajne starog grada i dijeli mudrost o skrivenim čarolijama. Daje ti napitak za koji obećava da će te vratiti u sadašnje vrijeme.

>uzmi napitak
Pažljivo uzimas napitak, osjećajući kako ti ruke blago drhte od uzbuđenja i straha.

Čim je napitak dotaknuo tvoje usne, svijet oko tebe se počinje vrtjeti nevjerojatnom brzinom. Kada se tvoj vid konačno razbistri, nalaziš se u potpuno drugačijem svijetu...

Neandertalsko Doba
Nalaziš se u neandertalskom dobu, okružena si prapovijesnom prirodom s visokim drvećem i zvukovima divljih životinja. Izgleda da si se vratila unatrag u vrijeme.

Dok se prilagođavaš novom okruženju, shvaćaš da si se vratila unazad u vremenu, u doba Neandertalaca. Ovdje, u ovom primitivnom i divljem svijetu, ne znaš kako bi se ponašala te ubrzo shvatiš da je tvom putovanju došao kraj

    *** Kraj igre - Lena je putovala predaleko u vrijeme da bi prezivjela. ***

Would you like to RESTART, RESTORE a saved game, QUIT or UNDO the last command?

>undo
Stravicna kuca
[Previous turn undone.]

>n
Napravili ste 7 koraka.

Glavni Trg
Nalaziš se na Glavnom Trgu u Novovjekovnom Gradu. To je živahno mjesto, s modernijim zgradama i šarenim svjetlima. Oko tebe se nalaze Gradski Park, Muzej, Stravična Kuća i Kavana,.

>e
Napravili ste 8 koraka.

Muzej
Muzej prepun povijesnih eksponata koji pričaju priču o gradu i njegovim tajnama.

Cuvar, strastveni čuvar povijesti grada u muzeju, brižno se brine o svakom eksponatu.

You can also see Futuristi ka oprema here.

>razgovaraj s cuvar
Čuvar s oduševljenjem dijeli zanimljivosti o najdražim eksponatima u muzeju. Dijeli i informacije o tome kako su neki ljudi ušli u muzej i nikad nisu izašli.

>istrazi muzej
Prolaziš kroz muzej, promatrajući razne eksponate. Osim povijesnih artefakata, primjećuješ nekoliko predmeta koji izgledaju kao da pripadaju budućnosti. Točnije vidiš futurističku opremu sličnu tvojoj u laboratoriju.